25 0 0 0 0 0 0 0 0 0 0 0 0 0 0 0 0 0 0 0 0 0 0 0 0 0 0 0 0 0 0 0 0 0 0 0
25 0 0 0 0 0 0 0 0 0 0 0 0 0 0 0 0 0 0 0 0 0 0 0 0 0 0 0 0 0 0 0 0 0 0 0
25 0 0 0 0 0 0 0 0 0 43 44 45 0 0 0 0 0 0 0 0 0 0 0 0 0 0 0 0 0 0 0 0 0 0 0
25 0 0 0 0 0 0 0 0 0 51 52 53 0 0 0 0 0 0 0 0 0 0 0 0 0 0 0 0 0 0 0 0 0 0 0
25 43 44 44 45 0 0 0 0 0 0 0 0 0 0 0 0 0 0 72 0 0 43 44 44 44 45 0 0 0 0 0 0 0 0 0
25 51 52 52 53 0 0 0 0 0 0 0 0 0 0 0 0 0 0 80 0 0 51 52 52 52 53 0 0 0 0 0 0 0 43 44
25 0 0 0 0 0 0 0 0 0 0 4 4 0 0 0 0 0 0 80 0 0 0 0 0 0 0 0 0 0 0 0 0 0 51 52
25 0 0 0 0 0 0 0 0 0 4 4 4 0 0 0 0 0 0 80 0 0 0 0 0 0 0 0 0 0 0 0 0 0 0 0
25 0 0 0 0 0 0 0 0 4 4 4 4 0 0 0 0 0 0 80 0 0 0 0 0 0 0 0 0 0 0 0 0 0 0 0
25 0 0 0 0 0 0 0 4 4 4 4 4 0 0 0 0 0 0 80 0 0 0 0 0 0 0 0 0 0 0 0 0 0 0 0
25 0 0 0 0 0 0 4 4 4 4 4 4 0 0 0 0 0 0 80 0 0 0 0 0 0 0 67 67 67 0 0 0 0 0 0
25 0 0 0 0 0 4 4 4 4 4 4 4 0 0 0 0 0 0 80 0 0 0 0 0 0 0 73 74 75 0 0 0 0 0 0
25 0 0 0 0 4 4 4 4 4 4 4 4 0 0 0 0 0 0 80 0 0 0 0 0 0 65 66 66 66 65 0 0 0 0 0
25 15 16 0 4 4 4 4 4 4 4 4 4 0 0 0 0 0 0 80 0 0 0 0 0 0 74 74 68 74 74 0 0 0 0 0
25 23 24 4 4 4 4 4 4 4 4 4 4 60 0 64 0 0 0 4 0 0 62 0 0 0 74 74 76 74 74 0 0 0 0 0
1 1 1 1 1 1 1 1 1 1 1 1 1 1 1 1 1 1 1 1 1 1 1 1 1 1 1 1 1 1 1 1 1 1 1 1
1 1 1 1 1 1 1 1 1 1 1 1 1 1 1 1 1 1 1 1 1 1 1 1 1 1 1 1 1 1 1 1 1 1 1 1
1 1 1 1 1 1 1 1 1 1 1 1 1 1 1 1 1 1 1 1 1 1 1 1 1 1 1 1 1 1 1 1 1 1 1 1
1 1 1 1 1 1 1 1 1 1 1 1 1 1 1 1 1 1 1 1 1 1 1 1 1 1 1 1 1 1 1 1 1 1 1 1
1 1 1 1 1 1 1 1 1 1 1 1 1 1 1 1 1 1 1 1 1 1 1 1 1 1 1 1 1 1 1 1 1 1 1 1
1 1 1 1 1 1 1 1 1 1 1 1 1 1 1 1 1 1 1 1 1 1 1 1 1 1 1 1 1 1 1 1 1 1 1 1
1 1 1 1 1 1 1 1 1 1 1 1 1 1 1 1 1 1 1 1 1 1 1 1 1 1 1 1 1 1 1 1 1 1 1 1